[DanhMuc/List]
ChucVuDoanThe=Chức vụ đoàn thể
TinhThanh=Tỉnh/Thành Phố
QuanHuyen=Quận/Huyện
PhuongXa=Phường/Xã
CoSo=Cơ sở
DonVi=Đơn vị
ChucDanhChuyenMon=Chức danh chuyên môn
ChucVuDoanDang=Chức vụ Đoàn/Đảng
CongTacDoanThe=Công tác Đoàn/Đảng
GiaDinhChinhSach=Loại gia đình chính sách
HangThuongBinh=Hạng thương binh
HinhThucKyLuat=Hình thức kỷ luật
HinhThucKhenThuong=Hình thức khen thưởng
HocVi=Học vị
KhoaGiangDay=Khoa giảng dạy
LoaiBangCap=Loại bằng cấp
LoaiCongTac=Loại công tác
LoaiDiaChiNha=Loại địa chỉ nhà
LoaiKhoaHoc=Loại khóa học
LoaiQuyetDinh=Loại quyết định
LoaiTheDinhDanh=Loại thẻ định danh
NganhGiangDay=Ngành giảng dạy
NoiHoc=Nơi học
PhanLoaiCBGVNV=Phân loại CBGVNV
QuanHamQuanDoi=Quân hàm quân đội
QuocGia=Quốc gia
ThanhPhanGiaDinh=Thành phần gia đình
TrinhDoChinhTri=Trình độ chính trị
TrinhDoHocVan=Trình độ học vấn
TrinhDoNgoaiNgu=Trình độ ngoại ngữ
TrinhDoQuanLy=Trình độ quản lý
TrinhDoTinHoc=Trình độ tin học
VanBang=Văn bằng
XepLoaiTotNghiep=Xếp loại tốt nghiệp
LoaiTotNghiep=Loại tốt nghiệp
BangCapSuPham=Bằng cấp sư phạm
LoaiChungChiNgoaiNgu=Loại chứng chỉ Ngoại ngữ
LoaiChungChiTinHoc=Loại chứng chỉ Tin học
NgoaiNgu=Ngoại ngữ
TrinhDo=Trình độ
TrinhDoChuyenMonCaoNhat=Trình độ chuyên môn cao nhất
TrinhDoLyLuanChinhTri=Trình độ lý luận chính trị
ChuyenNganh=Chuyên ngành
HocHam=Học hàm
ChucVu=Chức vụ
ChucDanh=Chức danh
ChucDanhGiangVien=Chức danh giảng viên
NhomGiangVien=Nhóm giảng viên
NhomNganh=Nhóm ngành
LoaiHinhDaoTao=Loại hình đào tạo
HienTrangDaoTao=Hiện trạng đào tạo
TrangThaiHoSo=Trạng thái hồ sơ
NgheNghiep=Nghề nghiệp
HienTrangNgheNghiep=Hiện trạng nghề nghiệp
DanToc=Dân tộc
DanTocThieuSo=Dân tộc thiểu số
GioiTinh=Giới tính
TonGiao=Tôn giáo
MoiQuanHe=Mối quan hệ gia đình
ThuongBinh=Thương binh
ConNhaChinhSach=Con nhà chính sách
QuanLyNhaNuoc=Quản lý nhà nước
HinhThucKyLuat=Hình thức kỷ luật
DanhHieuNhaGiao=Danh hiệu nhà giáo
DanhHieuThiDuaCaNhan=Danh hiệu thi đua cá nhân
DanhHieuThiDuaTapThe=Danh hiệu thi đua tập thể
DienBien=Diễn biến
BacLuong=Bậc lương
HeSoLuong=Hệ số lương
NhomNgach=Nhóm ngạch
NgachCongChucVienChuc=Ngạch công chức/viên chức
NoiDangKyKhamChuaBenh=Nơi đăng ký khám chữa bệnh
NgachVienChuc=Ngạch viên chức
NhomNgachVienChuc=Nhóm ngạch viên chức
BangLuong=Hệ số lương
QuyetDinh=Quyết định
[TaiNguyen/Create]
tenTaiNguyen=Tên tài nguyên
tepDinhKem=Tập tin đính kèm
[NhanVien/Index]
NhanVien=Nhân viên
MaHS=Mã hồ sơ
MaNV=Mã nhân viên
HoVaTen=Họ và tên
[nvTTCoBan/Create]
HoVaTen=Họ và tên
TenGoiKhac=Tên gọi khác
GioiTinh_id=Giới tính
NgaySinh=Ngày sinh
NoiSinh_id=Nơi sinh
QueQuan_id=Quê quán
DanToc_id=Dân tộc
TonGiao_id=Tôn giáo
ThanhPhanGiaDinh_id=Thành phần gia đình xuất thân
ThuongBinhLoai_id=Thương binh loại
GiaDinhLietSi=Gia đình liệt sĩ
[nvTTDinhDanh/Create]
QuocTich_id=Quốc tịch
QuocTich2_id=Quốc tịch 2
CMND_id=Chứng minh nhân dân
HoChieu_id=Hộ chiếu
TheSiQuan_id=Thẻ sĩ quan
LoaiThe_id=Loại thẻ
SoThe=Số thẻ
NgayCap=Ngày cấp
NoiCap_id=Nơi cấp
NgayHetHan=Ngày hết hạn
LaDangVien=Là Đảng viên
LaQuanNhan=Là quân nhân
[nvLSCongTac/Index]
DonViCongTac=Đơn vị công tác
ThoiGianBatDau=Bắt đầu
ThoiGianKetThuc=Kết thúc
TuNgay=Từ ngày
DenNgay=Đến ngày
ChucDanhChucVu=Chức danh/Chức vụ
[BangCap]
TenLoaiBangCap=Loại bằng cấp
Tennhomnganh=Nhóm ngành
TenChuyenNganh=Chuyên ngành
TenTruong=Tên Trường
TenLoaiKhoaHoc=Loại khóa học
TenLoaiHinhDaoTao=Loại hình ĐT
ThoiGianHoc=Thời gian học
ThoiGianBatDau=Bắt đầu
ThoiGianKetThuc=Kết thúc
KetQuaHocTap=Kết quả
XepLoaiTotNghiep=Xếp loại
tdChuyenMonCaoNhat=Trình độ cao nhất
[nvTTLienHe/Create]
HoKhauThuongTru_id=Hộ khẩu thường trú
DiaChiTamTru_id=Địa chỉ tạm trú
DiaChiLienLac_id=Địa chỉ liên lạc
LoaiDiaChi_id=Loại địa chỉ
DiaChi=Địa chỉ
PhuongXa_id=Xã, phường
QuanHuyen_id=Huyện, quận
TinhThanh_id=Tỉnh, TP.
DienThoaiNhaRieng=Điện thoại nhà riêng
DienThoaiDiDong=Điện thoại di động
DiaChiEmailTruong=Địa chỉ Email trường
DiaChiEmailKhac=Địa chỉ Email khác
[HSNhanSu/Details]
nvTTCoBan=Thông tin cơ bản
nvTTDinhDanh=Thông tin định danh
nvTTLienHe=Thông tin liên hệ
[nvTTDinhDanh/Details]
CMND_id=CMND
[nvSoYeuLyLich/Create]
nvSoYeuLyLich=Sơ yếu lý lịch
HoVaTen=Họ và tên khai sinh
NgaySinh=Sinh ngày
HoKhauThuongTru_id=Nơi đăng ký hộ khẩu thường trú
NoiOHienNay_id=Nơi ở hiện nay
NgheNghiep=Nghề nghiệp khi được tuyển dụng
CoQuanTuyenDung=Cơ quan tuyển dụng
ChucVuHienTai=Chức vụ/chức danh hiện tại
NgachVienChuc_id=Ngạch công chức/viên chức
MaNgachVienChuc=Mã ngạch
BacLuong_id=Bậc lương
HeSoBacLuong=hệ số
TrinhDoHocVan_id=Trình độ giáo dục phổ thông
LyLuanChinhTri_id=Lý luận chính trị
TrinhDoNgoaiNgu_id=Ngoại ngữ
TrinhDoTinHoc_id=Tin học
QuanLyNhaNuoc_id=Quản lý nhà nước
NgayVaoDang=Ngày vào Đảng cộng sản Việt Nam
NgayVaoDangChinhThuc=Ngày chính thức
HoatDongDoanHoi=Tham gia tổ chức chính trị-xã hội
NgayNhapNgu=Ngày nhập ngũ
NgayXuatNgu=Ngày xuất ngũ
QuanHamCaoNhat_id=Quân hàm cao nhất
DanhHieuCaoNhat_id=Danh hiệu được phong tặng cao nhất
SoTruongCongTac=Sở trường công tác
ChieuCao=Chiều cao
CanNang=Cân nặng
TinhTrangSucKhoe=Tình trạng sức khỏe
LaThuongBinhHang_id=Là thương binh hạng
GiaDinhChinhSach_id=Là con gia đình chính sách
ChungMinhNhanDan_id=Số chứng minh nhân dân
BaoHiemXaHoi=Số sổ bảo hiểm xã hội
HocHam_id=Học hàm
HocVi_id=Trình độ chuyên môn cao nhất
DaNghiHuu=Đã nghỉ hưu
[nvTTMoRong/Details]
NgayTuyenDung=Ngày tuyển dụng
ChucVuHienTai=Chức vụ hiện tại
CongViecDuocGiao=Công việc chính được giao
NgachCongChuc=Ngạch viên chức
MaNgach=Mã ngạch
BacLuong=Bậc lương
HeSo=Hệ số
NgayHuongLuong=Ngày hưởng
PhuCapChucVu=Phụ cấp chức vụ
PhuCapKhac=Phụ cấp khác
[nvCTDoanThe/Index]
ThoiGianBatDau=Từ tháng/năm
ThoiGianKetThuc=đến tháng/năm
NoiDungCongTac=Chức danh, chức vụ, đơn vị công tác (đảng, đoàn thể, tổ chức xã hội)
[nvQuanHeGiaDinh/Index]
QuanHe_id=Mối quan hệ
HoTen=Họ và tên
NgaySinh=Năm sinh
MaSoThue=Mã số thuế
NgheNghiep=Nghề nghiệp
CoQuan=Nơi công tác
DiaChi=Nơi cư trú
[Vietnamese/All]
CapNhat=Cập nhật
CapNhatThanhCong=Cập nhật thông tin thành công
CapNhatKhongThanhCong=Cập nhật thông tin không thành công
QuayVeDSNV=Quay về Danh sách Nhân viên
GhiChu=Ghi chú
LoaiChungChi=Tên chứng chỉ
CapDo=Xếp loại, điểm
NoiCap=Nơi cấp
HieuLuc=Hiệu Lực
BacHoc=Bậc học
TruongHoc=Trường học 
NamBatDau=Năm bắt đầu
NamKetThuc=Năm kết thúc
CheDoHoc=Chế độ học
DanhHieu=Danh hiệu
HienTrangDiHoc=Hiện trạng đi học
LoaiHocTap=Loại học tập
DanhHieuPhongTang=Danh hiệu phong tặng